Investigation Title	Analysis of TCGA GBM Whole-Exome Sequencing (WES) and RNA-Seq data
Experimental Design	individual_genetic_characteristics_design
Experimental Design Term Source REF	MGED Ontology
Experimental Factor Name	somatic_variant
Experimental Factor Type	disease_state

Person Last Name	Radenbaugh
Person First Name	Amie
Person Mid Initials	J
Person Email	aradenba@soe.ucsc.edu
Person Address	University of California Santa Cruz, 1156 High St, Mail Stop CBSE, Santa Cruz, CA 95064, USA
Person Affiliation	University of California Santa Cruz Genome Institute
Person Roles	submitter

PubMed ID	25405470
Publication Author List	Radenbaugh AJ, Ma S, Ewing A, Stuart JM, Collisson EA, Zhu J, Haussler D
Publication Title	RADIA: RNA and DNA Integrated Analysis for Somatic Mutation Detection
Publication Status	published
Experiment Description	Detection of somatic variants from the TCGA Whole-Exome Sequencing (WES) and RNA-Seq data using RADIA

Protocol Name	ucsc.edu:variant_calling:Illumina_DNASeq:01	ucsc.edu:vcf2maf:Illumina_DNASeq:01
Protocol Type	Variant Calling	MAF Generation
Protocol Description	Somatic Variant Calling Pipeline: RADIA v1.1.3 (https://github.com/aradenbaugh/radia/)	Annotation: SnpEff v3.3_GRCh37.69 (http://snpeff.sourceforge.net/)
Protocol Term Source REF	MGED Ontology	MGED Ontology
Protocol Parameters	

SDRF Files	ucsc.edu_GBM.IlluminaGA_DNASeq_automated.sdrf.txt

Term Source Name	MGED Ontology
Term Source File	http://mged.sourceforge.net/ontologies/MGEDontology.php
Term Source Version	1.3.1.1
